..........
.   .    .
. . . ........
. . .        .
. . .  . ... .
. . .  . . . .
.S.     E.   .
..............